111111111
1CCCCCCC1
1CECCCCC1
1CPCCCCC1
111111111