111111111111111111111
100000C00000000000001
1000100E0000000000001
1C0P10000000000000001
10001C000000000000001
10C011100000000000001
111111111111111111111