111111111111111111111111
100000000000011111110001
1000111000000000P0000001
10000C100001111111111011
100011100000000000011001
100000000001111111001001
1000000000000000010010C1
101111111111111111101011
10100000000000000100C101
101111111000000001111101
1000000E1000000000000001
111111111111111111111111